0,0,0,0,0,0,0,0,0,0,0,0,0,0,0,0,0,0,0,0,0,0,0,0
1,1,1,1,1,1,0,0,0,0,2,2,2,2,0,0,0,0,3,3,3,3,3,3
1,1,1,1,1,1,0,0,2,2,2,2,2,2,2,2,0,0,3,3,3,3,3,3
1,1,1,1,1,1,0,0,2,2,2,2,2,2,2,2,0,0,3,3,3,3,3,3
1,1,1,1,1,1,0,0,2,2,2,2,2,2,2,2,0,0,3,3,3,3,3,3
1,1,1,1,1,1,0,0,2,2,2,2,2,2,2,2,0,0,0,3,3,3,3,0
,1,1,1,1,1,0,0,2,2,2,2,2,2,2,2,0,0,0,0,0,0,0,0
0,0,0,0,0,0,0,0,2,2,2,2,2,2,2,2,0,0,0,0,0,0,0,0
0,0,0,0,0,0,0,0,0,0,0,0,0,0,0,0,0,0,4,4,4,4,4,4
9,9,9,9,9,0,0,0,0,0,0,0,0,0,0,0,0,0,4,4,4,4,4,4
9,9,9,9,9,9,9,9,0,0,0,0,0,0,0,0,0,0,4,4,4,4,4,4
9,9,9,9,9,9,9,9,0,0,0,0,0,0,0,0,0,0,4,4,4,4,4,4
9,9,9,9,9,9,9,9,0,0,0,0,0,0,0,0,0,0,4,4,4,4,4,4
9,9,9,9,9,9,9,9,0,0,0,0,0,0,0,0,0,0,0,0,0,0,0,0
9,9,9,9,9,9,9,9,0,0,0,0,0,0,0,0,0,0,5,5,5,5,5,0
9,9,9,9,9,9,9,9,0,0,0,0,0,0,0,0,0,5,5,5,5,5,5,5
0,0,0,0,0,0,0,0,0,0,0,0,0,0,0,0,0,5,5,5,5,5,5,5
0,0,0,0,0,0,0,0,0,0,0,0,0,0,0,0,0,5,5,5,5,5,5,5
0,0,0,0,0,0,0,0,0,7,7,7,7,7,7,0,0,0,5,5,5,5,5,0
8,8,8,8,8,8,8,0,0,7,7,7,7,7,7,0,0,0,0,0,0,0,0,0
8,8,8,8,8,8,8,0,0,7,7,7,7,7,7,0,0,0,0,0,0,0,0,0
8,8,8,8,8,8,8,0,0,7,7,7,7,7,7,0,0,6,6,6,6,6,6,6
8,8,8,8,8,8,8,0,0,7,7,7,7,7,7,0,0,6,6,6,6,6,6,6
8,8,8,8,8,8,8,0,0,7,7,7,7,7,7,0,0,6,6,6,6,6,6,6
8,8,8,8,8,8,0,0,0,7,7,7,7,7,7,0,0,0,6,6,6,6,6,6
